XXXXXXXXXXXXXXXXXXXXXXXXXXXXXXXX
XS                             X 
XXXXXXXXXXXXXXXXXXXXXXXXXXXXXX X
X                         X    X 
X XXXXXXXXXXXXXXXXXXXXXXX X XXXX
X X   X                 X X    X
X X X X XXXXX XXXXXXXXX X XXXX X
X X X X X   X X       X X      X
X X X X X X X X XXXXX XXXXXXXX X
X   X   X X   X X     X        X
XXXXXXXXX XXXXX X XXXXX X X X  X
X       X X     X     X X X X XX
X X X XXX X XXXXXXXXX X XXX X  X
X X X X   X X X       X   X XX X
X X XXX XXX X XXXXXXX XXX X X  X
X X X   X     X     X   X     XX
X XXX XXX XXX X     XXX X X X  X
X     X   X   X    E    X X XX X
X XXXXX XXX XXX     XXX X X X  X
X X     X X   X     X   X X    X
X X X XXX XXX XXXXXXX XXX X XX X
X X X X           X X     X    X
X X X X XXXXXXX X X XXXXXXX X  X
X X X   X     X X   X X     XX X
X X X X X XXXXXXXXXXX X XXX X  X
X X X X X X         X     X X XX
X X X XXX X XXXXX X XXX XXX X  X
X X X     X     X           X XX
X X XXXXXXXXXXX XXXXXXX XXX X  X
X X   X   X     X X   X X      X
X   X   X   XXX     X X X      X
XXXXXXXXXXXXXXXXXXXXXXXXXXXXXXXX